R 1280 720
 
NO ./textures/north.xpm
SO ./textures/south.xpm
WE ./textures/west.xpm
EA ./textures/east.xpm
S  ./textures/sprite.xpm
F 0, 179, 60
C 204, 242, 255   

        1111111111111111111111111
        1000000000110002000000001
        101100000111000200W000001
        1001000000002000000000001
111111111011000001110000000000001
100000000011000001110111111111111
11110111111111011100000010001
11110111111111011101010010001
11000000110101011100000010001
10002000000000001100000010001
10000000000000001101010010001
11000001110101011111011110011
11110111 1110101 101111010001
11111111 1111111 111111111111
